absolutnie===абсолютно
adres===обращаться
akt===действовать
akurat===акурат
ależ===но
ani===ни
ano===ано
armia===армия
atak===атака
autor===автор
babcia===бабушка
baron===барон
bezpiecznie===безопасно
bezpośrednio===напрямую
bezradnie===беспомощно
biegiem===бежать
blask===блик
bodaj===возможно
bogini===богиня
bok===сторона
boleśnie===болезненно
bowiem===для
brać===взять
broń===оружие
brzeg===край
brzuch===живот
burza===шторм
byle===пока
bynajmniej===по крайней мере
bóg===бог
bój===борьба
ból===боль
bądź===быть
błysk===вспышка
błyskawicznie===вспышка
błąd===ошибка
całkiem===совсем
całość===целый
centrum===центр
cesarz===император
charakter===персонаж
chleb===хлеб
cholera===холера
cholernie===проклятый
choć===хотя
chwila===момент
chyba===возможно
chętnie===желание
chęć===желание
chłodno===прохладно
chłop===крестьянин
chłód===прохлада
cicho===тихо
ciekawość===любопытство
ciemność===темнота
ciepło===тепло
cierpliwie===терпеливо
cień===тень
ciocia===тётушка
cios===дуть
ciotka===тётушка
ciężar===бремя
ciężko===тяжело
cokolwiek===всё
coraz===когда-либо
cud===чудо
cudem===чудо
cudownie===чудесно
czego===что
czemu===почему
czoło===лоб
czterdzieści===сорок
cztery===четыре
czuć===чувствовать
czwarty===четвертый
czym===что
czynić===делать
czysto===чисто
czytać===читать
czyż===делать
częściowo===частично
cóż===что
dach===крыша
dama===дама
dane===данные
dar===подарок
delikatnie===нежно
deszcz===дождь
dlatego===поэтому
dno===дно
dodatek===дополнение
dojść===достичь
dokoła===вокруг
doktor===доктор
dokąd===где
dokładnie===именно
doprawdy===действительно
dopuścić===разрешить
dostatecznie===достаточно
dosyć===достаточно
dosłownie===буквально
dotychczas===до сих пор
dotąd===до сих пор
doświadczenie===опыт
dość===довольно
dreszcz===вздрагивать
drobne===хорошо
drzwi===дверь
duch===дух
dusza===душа
dwa===два
dwadzieścia===двадцать
dwaj===два
dwanaście===двенадцать
dwieście===двести
dwoje===два
dwukrotnie===в два раза
dwór===суд
dym===дым
dyrektor===директор
działo===пушка
dziedziniec===двор
dzieje===история
dziewięć===девять
dzieło===художественное произведение
dzisiaj===сегодня
dziwnie===странно
dół===вниз
echo===эхо
efekt===эффект
facet===парень
fakt===факт
faktycznie===на самом деле
fala===волна
film===фильм
gardło===горло
garść===горсть
gdyby===если
gdyż===с
generał===общий
gest===жест
gniew===гнев
gniewnie===гневно
gorąco===горячо
gorączkowo===лихорадочно
gospodarz===хозяин
grunt===заземлять
grzecznie===вежливо
gwałtownie===яростно
głupio===глупо
głód===голод
głąb===глубина
głęboko===глубина
hałas===шум
hej===привет
historia===история
honor===честь
hrabia===считать
ilekroć===когда
ilość===количество
inspektor===инспектор
interes===интерес
istnienie===существование
istnieć===существовать
istota===сущность
istotnie===действительно
jakby===как если бы
jakkolwiek===однако
jakoby===как будто
jakoś===как-то
jakże===как
jasno===ясно
jeden===один
jednakże===однако
jedno===один
jedynie===только
jego===его
jezioro===озеро
kapelusz===шляпа
kapitan===капитан
kark===шея
kiedykolwiek===когда-либо
kiedyś===однажды
kieliszek===стекло
kierowca===водитель
kierunek===направление
kilkakrotnie===несколько раз
kilkanaście===несколько раз
kochanie===дорогая
kogo===кто
kogoś===кто-то
kolej===превратиться
kompletnie===полностью
komputer===компьютер
komuś===кто-л./что-л.
kontakt===связаться
korytarz===коридор
kot===кошка
kościół===церковь
krew===кровь
krok===шаг
krzyk===крик
krzyż===крест
król===Король
krótko===кратко
krąg===круг
księżyc===луна
kształt===форма
którego===чей
któryś===который вы
któż===кто
kula===сфера
kurs===курс
kwestia===вопрос
kąt===угол
laboratorium===лаборатория
lada===счетчик
lato===лето
lecz===но
ledwie===едва
ledwo===едва
lekarz===доктор
lekko===немного
lewo===слева
liczyć===граф
list===письмо
litość===милосердие
lord===лорд
los===судьба
lot===полет
lud===народная
lęk===тревога
major===главная
mama===мама
mary===мэри
maszyna===машина
materiał===материал
małżeństwo===брак
mianowicie===а именно
miał===был
miecz===меч
milczenie===молчание
mile===мили
mimo===несмотря на
mistrz===мастер
miłość===любовь
mnóstwo===много
mocno===сильно
moje===мой
morze===море
most===мост
mowa===речь
może===возможно
możliwość===возможность
mrok===темнота
mur===стена
muzeum===музей
myśl===мысль
myśleć===думать
mózg===мозг
nadal===до сих пор
nade===выше
nader===над
nadzieja===надеяться
nadzwyczaj===очень
nagle===внезапно
napis===надпись
naprzeciwko===напротив
naraz===сразу
nareszcie===наконец
nastrój===настроение
natomiast===пока
natura===природа
natychmiast===сразу
nauczyciel===учитель
nawzajem===друг друга
nazajutrz===на следующий день
nazbyt===тоже
nazwać===имя
nazwisko===имя
nerwowo===нервно
niby===как
niczego===ничего
niebawem===скоро
niebezpieczeństwo===опасность
niech===пусть
niechaj===пусть
niechętnie===неохотно
niecierpliwie===нетерпеливо
nieco===несколько
niedawno===недавно
niedługo===скоро
niegdyś===раньше
niekiedy===иногда
niemal===почти
nieomal===почти
niepewnie===неуверенно
niepokój===беспокойство
nieruchomo===все еще
niespodziewanie===неожиданно
nieszczęście===несчастье
nieustannie===постоянно
niewątpliwie===несомненно
niezależnie===независимо
niezmiernie===чрезвычайно
nieznajomy===незнакомец
niezupełnie===неполностью
niezwykle===чрезвычайно
nieśmiało===робко
nim===до
normalnie===обычно
nowo===недавно
numer===номер
nóż===нож
oba===оба
obcy===незнакомец
obecność===присутствие
obiad===ужин
oblicze===лицо
oboje===оба
obojętnie===равнодушно
obowiązek===долг
obraz===образ
obóz===лагерь
oczywiście===конечно
oddać===пожертвовать
oddech===дыхание
oddział===филиал
odejść===оставить
odgłos===звук
odkąd===с
odległość===расстояние
odpowiednio===соответственно
odpowiedzieć===ответ
odpowiedź===ответить
odruchowo===рефлексивно
odtąd===отныне
odwiedzić===посетить
odwrócić===обратиться
odzyskać===выздоравливать
ogień===огонь
ogromnie===безмерно
ogród===сад
ogół===общий
okno===окно
okropnie===ужасно
okrzyk===восклицание
omal===почти
opanować===хозяин
opowieść===история
oprzeć===сопротивляться
opór===сопротивляться
osobiście===лично
ostatnio===последний
otwarcie===открыто
otóż===хорошо
owszem===да
palec===палец
pamięć===память
panienka===мисс
panna===мисс
pas===ремень
pat===похлопать
pański===ваш
pewien===определенный
pewność===уверенность
pełen===полный
pełno===полный
piasek===песок
pierścień===кольцо
pieśń===песня
pilot===пилот
pisarz===писатель
pistolet===пистолет
pióro===ручка
piętnaście===пятнадцать
pięć===пять
plan===план
plecy===назад
pociąg===поезд
poczekać===ждать
poczucie===чувствовать
początek===начать
podjąć===взяться
podobnie===аналогично
podobno===по сообщениям
podróż===путешествие
poeta===поэт
pogodzić===примириться
pojechać===идти
pokonać===преодолеть
pokład===палуба
pole===поле
polecenie===командование
policja===полиция
policjant===полицейский
pomieszczenie===комната
pomimo===несмотря на
pomiędzy===между
pomocy===помощь
ponad===через
ponownie===снова
ponuro===мрачно
poprzednio===ранее
poruszać===двигаться
porządek===заказать
posiłek===еда
postawić===место
postać===фигура
pot===потеть
potem===затем
poważnie===серьезно
powietrze===воздух
powieść===роман
powrót===вернуться
powszechnie===обычно
powód===причина
poza===за пределами
pozbyć===избавиться
pozostać===оставаться
połączenie===связь
pośpiesznie===поспешно
pośrodku===в середине
pośród===в разгар
pragnienie===желание
praktycznie===практически
prawie===почти
prezydent===президент
problem===проблема
procent===процент
profesor===профессор
program===программа
prosta===просто
przecież===в конце концов
przeciw===против
przeciwko===против
przeciwnie===против
przejście===переход
przekazać===перевод
przenieść===передача
przestrzeń===место
przeszłość===мимо
przeto===поэтому
przeważnie===в основном
przeze===мной
przy===на
przygotować===подготовить
przyjaźń===дружба
przyjemnie===приятно
przyjemność===удовольствие
przyjrzeć===смотреть
przyjęcie===приветствовать
przykro===извините
przykład===пример
przynajmniej===по крайней мере
przypadek===случай
przyszłość===будущее
przytomność===сознание
próba===попытка
prócz===кроме того
próżno===тщетная
prąd===настоящее
prędko===быстро
pułkownik===полковник
póki===до тех пор, пока
pół===половина
północ===полночь
późno===поздно
płacz===плакать
płakać===плакать
płomień===пламя
rad===rad
rada===совет
radość===радость
ramię===рука
rana===рана
ranny===раненый
razy===времена
reszta===отдых
rozdział===глава
rozległy===большая
rozpaczliwie===отчаянно
rozpoznać===узнать
rozwiązanie===решение
ryk===рев
rytm===ритм
rzeczywistość===реальность
rzut===проекция
róg===рог
równie===одинаково
również===также
równocześnie===в то же время
sam===сам
samolot===самолёт
samotnie===один
samotny===один
scena===сцена
schody===лестница
sen===сон
sens===чувство
serdecznie===искренне
siebie===себя
siedzieć===сидеть
sierżant===сержант
silnie===сильно
silnik===двигатель
skarb===сокровище
skoro===с
skutek===эффект
smak===вкус
smok===дракон
smutek===грусть
smutno===грусть
spacer===прогулка
spać===спать
specjalnie===специально
spod===из-под
spodnie===брюки
spojrzeć===смотреть
spokojnie===спокойно
sporo===много
spory===много
sprawić===сделать
sprzed===до
spędzić===тратить
stale===постоянно
stanie===стоять
stanowczo===твёрдо
stanowisko===позиция
starannie===осторожно
staruszka===старушка
sto===сто
stopniowo===постепенно
stos===стопка
stosunek===половой акт
strach===страх
stracić===потерять
strasznie===ужасно
straszny===страшный
strażnik===охрана
strumień===поток
strzał===выстрел
strój===наряд
stworzenie===существо
sufit===потолок
sukces===успех
surowo===строго
swoje===его
sygnał===сигнал
system===система
szansa===шанс
szczyt===пик
szczęśliwie===удача
szef===шеф
sześć===шесть
sześćdziesiąt===шестьдесят
szkoda===жалость
szukać===искать
szum===шум
sędzia===судить
słabo===плохо
słusznie===справедливо
służba===сервис
tajemnica===секретность
także===также
tamten===это
tata===папа
tego===этот
tekst===смс
telefon===телефон
też===также
tom===Том
ton===тон
toteż===тото
towarzysz===компаньон
treść===содержание
troje===три
trudno===трудный
trzask===треск
trzeba===вам нужно
trzeci===третий
trzej===три
trzy===три
trzydzieści===тридцать
trzymać===держите
tutaj===здесь
tuż===просто
twarz===лицо
tytuł===название
tył===назад
tłum===толпа
ucha===ухо
uczucie===чувство
uczuć===чувства
uczyć===научить
udać===притворяться
udział===поделиться
ukradkiem===стелс
układ===система
umysł===ум
upewnić===убедиться
uratować===сохранить
usiąść===сидеть
usta===рот
ustalić===определить
utrzymać===держать
uwaga===внимание
uśmiech===улыбаться
użyć===использовать
walka===бороться
wasz===ваш
wał===вал
wbrew===против
wcześnie===рано
wedle===согласно
według===согласно
wejście===вход
wesoło===весело
wiadomość===сообщение
wiatr===ветер
widocznie===очевидно
widok===смотреть
wiecznie===вечно
wielokrotnie===неоднократно
wina===вино
winien===вино
wnętrze===интерьер
wojsko===армия
wokół===вокруг
wola===будет
wolność===свобода
worek===сумка
woń===аромат
wpół===половина
wpływ===воздействие
wrażenie===впечатление
wreszcie===наконец-то
wschód===восток
wskutek===благодаря
wspaniale===чудесно
wspomnienie===память
wspólnie===вместе
wstać===встать
wstyd===стыд
wszak===в конце концов
wszakże===после всего
wszelki===все
wtem===wtem
wuj===дядя
wybór===выбор
wydawać===выпуск
wydostać===выбраться
wygląd===смотреть
wyglądać===смотреть
wygodnie===удобно
wyjaśnić===объяснить
wyjechać===оставить
wyjątkowo===уникально
wyjście===выйти
wyjść===выход
wykonać===выполнить
wykorzystać===использовать
wypadek===авария
wyraz===слово
wyraźnie===ясно
wyrwać===вырвать
wysoko===высота
wysokość===высота
wystarczająco===достаточно
wytrzymać===держать
wyłącznie===только
wzdłuż===вдоль
względem===относительно
wzrok===зрения
wódz===лидер
wówczas===затем
wóz===тележка
władca===линейка
własny===собственный
właściwie===на самом деле
włosy===волосы
wściekłość===ярость
zabawa===веселье
zachowanie===поведение
zachód===запад
zadanie===задача
zadać===нанести
zaledwie===просто
zamek===замок
zamiar===намерение
zapach===запах
zapewne===возможно
zapewnić===предоставить
zapomnieć===забыть
zapłacić===платить
zaraz===скоро
zarazem===в одно и то же время
zarówno===оба
zaufanie===доверять
zauważyć===заметить
zawartość===содержание
zazwyczaj===обычно
załoga===команда
zbytnio===слишком
zdanie===фраза
zdarzyć===произойти
zdecydowanie===определенно
zdjęcie===картина
zdolność===способность
zdolny===способный
zebrać===собирать
zegar===часы
zegarek===смотреть
zejść===спускаться
zewnątrz===снаружи
zgoda===соглашение
zgodnie===согласно
zgoła===вдоль
zimno===холод
zjeść===есть
zmusić===сила
znaczenie===значение
znacznie===значительно
znad===с
znakomicie===великолепно
znieść===упразднить
zniszczyć===уничтожить
znowu===снова
znów===снова
zresztą===более того
zwycięstwo===победа
zwyczaj===на заказ
zwłaszcza===особенно
zza===сзади
zło===зло
złoto===золото
złość===злой умысел
złożyć===файл
ładnie===красивая
łagodnie===нежно
łeb===голова
łuk===нос
łódź===лодка
ściana===стена
ślad===след
ślub===свадьба
śmiać===смех
śmiertelnie===смертельный
śniadanie===завтрак
śnieg===снег
śpiew===пение
świadomość===осознание
świetnie===великий
święta===праздники
żaden===нет
żołnierz===солдат
żywo===ярко
żyła===жил